...00....12334568790
...00....12233456879
...00....12233456879
...00....12233456879
...00....12233456879
12233456879...00....
12233456879...00....
12233456879...00....
12233456879...00....
12233456879...00....

12233456879...00....
12233456879...00....
12233456879...00....
12233456879...00....
12233456879...00....
...00....12233456879
...00....12233456879
...00....12233456879
...00....12233456879
...00....12233456879

....................
...4..4......4..4...
..444444....444444..
...4..4......4..4...
.........00.........
.........00.........
...4..4......4..4...
..444444....444444..
...4..4......4..4...
....................