...00....12334568790
...00....12233456879
...00....12233456879
...00....12233456879
...00....12233456879
12233456879...00....
12233456879...00....
12233456879...00....
12233456879...00....
12233456879...00....

12233456879...00....
12233456879...00....
12233456879...00....
12233456879...00....
12233456879...00....
...00....12233456879
...00....12233456879
...00....12233456879
...00....12233456879
...00....12233456879